****************
            *  *
****  ****  *  *
*     *        *
*  *************
*     *        *
****  *  ****  *
*     *  *     *
*  *******  ****
*               
****************
