*******************************
            *     *     *     *
*******  *  *  *  ****  *  ****
*        *     *     *        *
*  ****************  *******  *
*  *     *     *        *     *
*  ****  *  *  *******  *  ****
*  *     *  *     *     *     *
*  *  ****  ****  *  ****  ****
*     *     *     *     *     *
*  ****  ****  ****  *  ****  *
*     *  *     *     *  *     *
****  *  *  ****  ****  ****  *
*  *     *  *  *  *     *     *
*  *******  *  *  *  ****  ****
*           *     *     *  *  *
****  *************  *  *  *  *
*     *        *     *  *  *  *
*  ****  *******  ****  *  *  *
*     *           *            
*******************************
